,#.............................
,#.....[,,,,,,,,,,,,,,,,,,,,,].
,#.....,,,,,,,,,,,,,,,,,,,,,,,.
,#..Z..,,,,,,,,,,,,,,,,,,,,,,,.
,#..Z.[,,,,,,XBBXBBBXBBXXX,,,,.
,,,Z,,,,,,,,#............#,,,,.
,,,,,,Z,,,,B............#,,,,..
,Z,,,,,,,,,B......######,,,,,..
,,,Z,,,,,,,B..........#,,,,,,..
,#....<,,,,,#....@.....#,,,,,,.
,####.Z######..........m,,,,,,.
,#.....,,,,,#..........#,,,,,,.
,#.....,,,,,#..........#,,,,,,.
,#.....,,,,,############,,,,,,.
,#.....<,,,,,,,,,,,,,,,,,,,,,>.
,..............................
