....Z...Z
.........
.........
.........
####B###B#
#........#
#...@,...#
####...###
...#...#
####...#####
#..........#
#..........#
#..........#
############
