.........
.........
....Z..Z.
.........
####BB#BB#####
#............#
#...@,.......#
####...######
...#...#
####...#####
#..........B
#..........#
#..........B
############
