,,,,#..............................................
,,,,#..............................................
,,,,#..............................................
,,,,#..............................................
,,,,#..............................................
,,,,#..............................................
,,,,#..............................................
,,,,#.....[,,,,,,,,,,,,,,,,,,,,,,,,,]..............
,,,,#.....,,,Z,,Z,,,,,,,,,Z,,,,,,,,,,..............
,,,,#.....,,,,,,,,,,,,,,,,,,,,,,,,,,,..............
,,,,#....[,,,,,XXBBXBBBXBBXXX,,,,,,,,Z...Z.........
,,,,,,,,,,,,,,,#............#,,,,,,,,..............
,,,,,,,,,,,,,,B............##########BBBBB######...
,,,,Z,,,,,,,,,B............,,,,,,,,,...........#...
,,,,,,,,,,,,,,B................................#...
,,,,#....<,,,,,#....@.....######################...
,,,,####..######..........m,,,,,,,,,,..............
,,,,#.....,,,,,#..........#,,,,,,,,,,..............
,,,,#.....,,,,,#..........#,,,,,,,,,,..............
,,,,#.....,,,,,############,,,,,,,,,,..............
,,,,#.....<,,,,,,,,,,,,,,,,,,,,,,,,,>..............
,,,,...............................................
,,,,...............................................
,,,,...............................................
,,,,...............................................
,,,,...............................................
,,,,...............................................
,,,,...............................................
,,,,...............................................
,,,,...............................................
