,,,,#.....[,,,,,,,,,,,,,,,,,,,,,,,,,]..............
,,,,#.....,,,Z,,,Z,Z,Z,Z,Z,Z,Z,Z,Z,,,..............
,,,,#.....,,,,,,,,,,,,,Z,,,,,,,,,,,,,..............
,,,,#....[,,,,,XXBBXBBBXBBXXX,,,,Z,,,..............
,,,,,,,,,,,,,,,#............#,,,,,,,,..............
,,,,Z,,,,,,,,,B............##########BBBBB######...
,,,,,,,,,,,,,,B............,,,,,,,,,...........#...
,,,,,,,,,Z,,,,B................................#...
,,,,#....<,,,,,#....@.....######################...
,,,,####..######..........m,,,,,,,,,,..............
,,,,#.....,,,,,#..........#,,,,,,,,,,..............
,,,,#....Z,,,,,#..........#,,,,,,,,,,..............
,,,,#.....,,,,,############,,,,,,,,,,..............
,,,,#.....<,,,,,,,,,,,,,,,,,,,,,,,,,>..............
