,,,,#..............................................
,,,,#.....[,,,,,,,,,,,,,,,,,,,,,,,,,]..............
,,,,#.....,,,,,,,,,,,,,,,,,,,,,,,,,,,..............
,,,,#.....,,,,,,,,,,,,,,,,,,,,,,,,,,,..............
,,,,#....[,,,,,,XBBXBBBXBBXXX,,,,,,,,..............
,,,,,,,,,,,,,,,#............#,,,,,,,,..............
,,,,,,,,,,,,,,B............#,,,,,,,,...............
,,,,Z,,,,,,,,,B......######,,,,,,,,,...............
,,,,,,,,,,,,,,B..........#,,,,,,,,,,...............
,,,,#....<,,,,,#....@.....#,,,,,,,,,,..............
,,,,####..######..........m,,,,,,,,,,..............
,,,,#.....,,,,,#..........#,,,,,,,,,,..............
,,,,#.....,,,,,#..........#,,,,,,,,,,..............
,,,,#.....,,,,,############,,,,,,,,,,..............
,,,,#.....<,,,,,,,,,,,,,,,,,,,,,,,,,>..............
,,,,...............................................
