.........
.........
....Z..Z.
.........
XXBBBBBBBBBXXX
#............#
#...@,.......#
#......######
#..........#
#..........#
#..........m
#..........#
#..........#
############
