,,,,#..............................................
,,,,#..............................................
,,,,#..............................................
,,,,#..............................................
,,,,#..............................................
,,,,#..............................................
,,,,#..............................................
,,,,#.....[,,,,,,,,,,,,,,,,,,,,,,,,,]..............
,,,,#.....,,,Z,,Z,,,,,,,,,Z,,,,,,,,,,..............
,,,,#.....,,,,,,,,,,,,,,,,,,,,,,,,,,,..............
,,,,#....[,,,,,XXBBXBBBXBBXXX,,,,,,,,..............
,,,,,,,,,,,,,,,#............#,,,,,,,,..............
,,,,,,,,,,,,,,B............#,,,,,,,,...............
,,,,Z,,,,,,,,,B......######,,,,,,,,,...............
,,,,,,,,,,,,,,B..........#,,,,,,,,,,...............
,,,,#....<,,,,,#....@.....#,,,,,,,,,,..............
,,,,####..######..........m,,,,,,,,,,..............
,,,,#.....,,,,,#..........#,,,,,,,,,,..............
,,,,#.....,,,,,#..........#,,,,,,,,,,..............
,,,,#.....,,,,,############,,,,,,,,,,..............
,,,,#.....<,,,,,,,,,,,,,,,,,,,,,,,,,>..............
,,,,...............................................
,,,,...............................................
,,,,...............................................
,,,,...............................................
,,,,...............................................
,,,,...............................................
,,,,...............................................
,,,,...............................................
,,,,...............................................
