@...#..#.......................
....#..........................
###....#Z#############.........
.......##......................
.....###.......................
...............................
...............................
