,,#.....[,,,,,,,,,,,,,,,,,,,,,,,,,]...........
,,#.....,,,Z,,,,,,,,,,,,,,,,,,,Z,,,...........
,,#.....,,,,,,,,,,,,,,,,,,,,,,,,,,,...........
,,#....[,,,,,XXBBXBBBXBBXXX,,,,,,,,...........
,,,,,,,,,,,,,#............#,,,,,,,,...........
,,Z,,,,,,,,,B............##########BBBBB######
,,,,,,,,,,,,B............,,,,,,,,,...........#
,,,,,,,,,,,,B................................#
,,#....<,,,,,#....@.....######################
,,####..######..........m,,,,,,,,,,...........
,,#.....,,,,,#..........#,,,,,,,,,,...........
,,#....Z,,,,,#..........#,,,,,,,,,,...........
,,#.....,,,,,############,,,,,,,,,,...........
,,#.....<,,,,,,,,,,,,,,,,,,,,,,,,,>...........
